18 18 18 18 18 18 18 18 18 18 18 18 18 18 18 18 18 18 18 18 18 18 18 18 18 18 18 18 18 18 18 18 18 18 18 18 18 18 18 18 18 18 18 18 18 18 18 18 18 18 18 18 18 18 18 18 18 18 18 18 18 18 18 18 18 18 18 18 18 18 18 18 18 18 18 18 18 18 18 18 18 18 18 18 18 18 18 18 18 18 18 18 18 18 18 18 18 18 18 18 
18 18 18 18 18 18 18 18 18 18 18 18 18 18 18 18 18 18 18 18 18 18 18 18 18 18 18 18 18 18 18 18 18 18 18 18 18 18 18 18 18 18 18 18 18 18 18 18 18 18 18 18 18 18 18 18 18 18 18 18 18 18 18 18 18 18 18 18 18 18 18 18 18 18 18 18 18 18 18 18 18 18 18 18 18 18 18 18 18 18 18 18 18 18 18 18 18 18 18 18 
18 18 18 18 18 18 18 18 18 18 18 18 18 18 18 18 18 18 18 18 18 18 18 18 18 18 18 18 18 18 18 18 18 18 18 18 18 18 18 18 18 18 18 18 18 18 18 18 18 18 18 18 18 18 18 18 18 18 18 18 18 18 18 18 18 18 18 18 18 18 18 18 18 18 18 18 18 18 18 18 18 18 18 18 18 18 18 18 18 18 18 18 18 18 18 18 18 18 18 18 
18 18 18 18 18 18 18 18 18 18 18 18 18 18 18 18 18 18 18 18 18 18 18 18 18 18 18 18 18 18 18 18 18 18 18 18 18 18 18 18 18 18 18 18 18 18 18 18 18 18 18 18 18 18 18 18 18 18 18 18 18 18 18 18 18 18 18 18 18 18 18 18 18 18 18 18 18 18 18 18 18 18 18 18 18 18 18 18 18 18 18 18 18 18 18 18 18 18 18 18 
18 18 18 18 18 18 18 18 18 18 18 18 18 18 18 18 18 18 18 18 18 18 18 18 18 18 18 18 18 18 18 18 18 18 18 18 18 18 18 18 18 18 18 18 18 18 18 18 18 18 18 18 18 18 18 18 18 18 18 18 18 18 18 18 18 18 18 18 18 18 18 18 18 18 18 18 18 18 18 18 18 18 18 18 18 18 18 18 18 18 18 18 18 18 18 18 18 18 18 18 
18 18 18 18 18 18 18 18 18 18 18 18 18 18 18 18 18 18 18 18 18 18 18 18 18 18 18 18 18 18 18 18 18 18 18 18 18 18 18 18 18 18 18 18 18 18 18 18 18 18 18 18 18 18 18 18 18 18 18 18 18 18 18 18 18 18 18 18 18 18 18 18 18 18 18 18 18 18 18 18 18 18 18 18 18 18 18 18 18 18 18 18 18 18 18 18 18 18 18 18 
18 18 18 18 18 18 18 18 18 18 18 18 18 18 18 18 18 18 18 18 18 18 18 18 18 18 18 18 18 18 18 18 18 18 18 18 18 18 18 18 18 18 18 18 18 18 18 18 18 18 18 18 18 18 18 18 18 18 18 18 18 18 18 18 18 18 18 18 18 18 18 18 18 18 18 18 18 18 18 18 18 18 18 18 18 18 18 18 18 18 18 18 18 18 18 18 18 18 18 18 
18 18 18 18 18 18 18 18 18 18 18 18 18 18 18 18 18 18 18 18 18 18 18 18 18 18 18 18 18 18 18 18 18 18 18 18 18 18 18 18 18 18 18 18 18 18 18 18 18 18 18 18 18 18 18 18 18 18 18 18 18 18 18 18 18 18 18 18 18 18 18 18 18 18 18 18 18 18 18 18 18 18 18 18 18 18 18 18 18 18 18 18 18 18 18 18 18 18 18 18 
18 18 18 18 18 18 18 18 18 18 18 18 18 18 18 18 18 18 18 18 18 18 18 18 18 18 18 18 18 18 18 18 18 18 18 18 18 18 18 18 18 18 18 18 18 18 18 18 18 18 18 18 18 18 18 18 18 18 18 18 18 18 18 18 18 18 18 18 18 18 18 18 18 18 18 18 18 18 18 18 18 18 18 18 18 18 18 18 18 18 18 18 18 18 18 18 18 18 18 18 
18 18 18 18 18 18 18 18 18 18 18 18 18 18 18 18 18 18 18 18 18 18 18 18 18 18 18 18 18 18 18 18 18 18 18 18 18 18 18 18 18 18 18 18 18 18 18 18 18 18 18 18 18 18 18 18 18 18 18 18 18 18 18 18 18 18 18 18 18 18 18 18 18 18 18 18 18 18 18 18 18 18 18 18 18 18 18 18 18 18 18 18 18 18 18 18 18 18 18 18 
18 18 18 18 18 18 18 18 18 18 18 18 18 18 18 18 18 18 18 18 18 18 18 18 18 18 18 18 18 18 18 18 18 18 18 18 18 18 18 18 18 18 18 18 18 18 18 18 18 18 18 18 18 18 18 18 18 18 18 18 18 18 18 18 18 18 18 18 18 18 18 18 18 18 18 18 18 18 18 18 18 18 18 18 18 18 18 18 18 18 18 18 18 18 18 18 18 18 18 18 
18 18 18 18 18 18 18 18 18 18 18 18 18 18 18 18 18 18 18 18 18 18 18 18 18 18 18 18 18 18 18 18 18 18 18 18 18 18 18 18 18 18 18 18 18 18 18 18 18 18 18 18 18 18 18 18 18 18 18 18 18 18 18 18 18 18 18 18 18 18 18 18 18 18 18 18 18 18 18 18 18 18 18 18 18 18 18 18 18 18 18 18 18 18 18 18 18 18 18 18 
18 18 18 18 18 18 18 18 18 18 18 18 18 18 18 18 18 18 18 18 18 18 18 18 18 18 18 18 18 18 18 18 18 18 18 18 18 18 18 18 18 18 18 18 18 18 18 18 18 18 18 18 18 18 27 27 27 27 27 27 27 27 27 18 18 18 18 18 18 18 18 18 18 18 18 18 18 18 18 18 18 18 18 18 18 18 18 18 18 18 18 18 18 18 18 18 18 18 18 18 
18 18 18 18 18 18 18 18 18 18 18 18 18 18 18 18 18 18 18 18 18 18 18 27 27 27 27 27 27 27 27 27 27 27 27 27 27 27 27 27 27 27 27 27 27 27 27 27 27 27 27 27 27 27 27 27 27 27 27 18 18 18 27 27 27 27 27 27 27 27 27 27 27 27 27 27 27 27 27 27 27 18 18 18 18 18 18 18 18 18 18 18 18 18 18 18 18 18 18 18 
18 18 18 18 18 18 18 18 18 18 18 18 18 18 18 18 18 18 18 18 18 18 27 27 27 27 27 27 27 27 27 27 27 27 27 27 21 1 1 1 1 1 1 1 1 1 11 27 27 18 18 18 18 18 27 27 27 21 1 1 1 1 1 1 1 11 27 27 27 18 27 21 1 1 1 1 1 11 27 27 27 27 27 18 18 18 18 18 18 18 18 18 18 18 18 18 18 18 18 18 
18 18 18 18 18 18 18 18 18 18 18 18 18 18 18 18 18 18 18 18 18 18 27 27 27 27 27 27 27 27 27 27 18 21 1 1 23 14 14 14 14 14 14 14 14 14 0 1 1 1 1 1 1 1 1 1 1 23 14 14 14 14 14 14 14 0 1 1 1 1 1 23 14 14 14 14 14 0 1 11 18 27 27 18 18 18 18 18 18 18 18 18 18 18 18 18 18 18 18 18 
18 18 18 18 18 18 18 18 18 18 18 18 18 18 18 18 18 18 18 18 18 27 27 27 27 27 27 27 27 27 27 21 1 23 14 14 14 14 14 14 14 14 14 14 14 14 14 14 14 14 14 14 14 14 14 14 14 14 14 14 14 14 14 14 14 14 14 14 14 14 14 14 14 14 14 14 14 14 14 0 11 27 27 18 18 18 18 18 18 18 18 18 18 18 18 18 18 18 18 18 
18 18 18 18 18 18 18 18 18 18 18 18 18 18 18 18 18 18 18 18 18 27 27 27 27 27 27 27 27 18 21 23 14 14 14 14 14 14 14 14 14 14 14 14 14 14 14 14 14 14 14 14 14 14 14 14 14 14 14 14 14 14 14 14 14 14 14 14 14 14 14 14 14 14 14 14 14 14 14 14 0 1 11 27 18 18 18 18 18 18 18 18 18 18 18 18 18 18 18 18 
18 18 18 18 18 18 18 18 18 18 18 18 18 18 18 18 18 18 18 18 27 27 27 27 27 27 27 27 18 21 23 14 14 14 14 14 14 14 14 14 14 14 14 14 14 14 14 14 14 14 14 14 14 14 14 14 14 14 14 14 14 14 14 14 14 14 14 14 14 14 14 14 14 14 14 14 14 14 14 14 14 14 0 11 18 18 18 18 18 18 18 18 18 18 18 18 18 18 18 18 
18 18 18 18 18 18 18 18 18 18 18 18 18 18 18 18 18 18 18 18 27 27 27 27 27 27 27 27 27 26 14 14 14 14 14 14 14 14 14 14 14 14 14 14 14 14 14 14 14 14 14 14 14 14 14 14 14 14 14 14 14 14 14 14 14 14 14 14 14 14 14 14 14 14 14 14 14 14 14 14 14 14 14 3 27 18 18 18 18 18 18 18 18 18 18 18 18 18 18 18 
18 18 18 18 18 18 18 18 18 18 18 18 18 18 18 18 18 18 18 27 27 27 27 27 27 27 27 27 27 20 22 14 14 14 14 14 14 14 14 14 14 14 14 14 14 14 14 14 14 14 14 14 14 14 14 14 14 14 14 14 14 14 14 14 14 14 14 14 14 14 14 14 14 14 14 14 14 14 14 14 14 14 14 3 18 18 18 18 18 18 18 18 18 18 18 18 18 18 18 18 
18 18 18 18 18 18 18 18 18 18 18 18 18 18 18 18 18 18 27 27 27 27 27 27 27 27 27 27 27 18 20 17 22 14 14 14 14 14 14 14 14 14 14 14 14 14 14 14 14 14 14 14 14 14 14 14 14 14 14 14 14 14 12 17 17 17 17 22 14 14 14 14 14 14 14 14 14 14 14 14 14 14 14 3 18 18 18 18 18 18 18 18 18 18 18 18 18 18 18 18 
18 18 18 18 18 18 18 18 18 18 18 18 18 18 18 18 18 27 27 27 27 27 27 27 27 27 27 27 27 27 27 27 20 22 14 14 14 14 14 14 14 14 14 14 14 14 14 14 14 14 14 14 14 14 14 14 14 14 12 17 17 17 13 27 18 18 27 20 17 17 17 17 17 17 17 17 17 17 17 17 17 22 12 13 18 18 18 18 18 18 18 18 18 18 18 18 18 18 18 18 
18 18 18 18 18 18 18 18 18 18 18 18 18 18 18 18 18 27 27 27 27 27 27 27 27 27 27 27 27 27 27 27 18 20 17 22 14 14 14 14 14 14 14 14 14 14 12 17 17 17 17 17 17 17 17 17 17 17 13 18 27 27 27 27 27 27 27 27 27 27 27 27 27 27 27 18 18 18 18 27 27 20 13 27 18 18 18 18 18 18 18 18 18 18 18 18 18 18 18 18 
18 18 18 18 18 18 18 18 18 18 18 18 18 18 18 18 27 27 27 27 27 27 27 27 27 27 27 27 27 27 27 27 27 27 27 20 17 17 17 17 17 17 17 17 17 17 13 18 27 27 27 27 27 27 27 18 18 18 18 27 27 27 27 27 27 27 27 27 27 27 27 27 27 27 27 27 27 27 27 27 27 27 27 27 18 18 18 18 18 18 18 18 18 18 18 18 18 18 18 18 
18 18 18 18 18 18 18 18 18 18 18 18 18 18 18 18 27 27 18 18 18 18 18 18 18 18 18 18 18 18 18 18 27 27 27 27 27 27 27 18 18 18 18 18 27 27 27 27 27 27 27 27 27 27 27 27 27 27 27 27 27 27 27 6 6 6 6 6 6 6 6 6 6 6 6 27 27 27 27 27 27 27 27 27 18 18 18 18 18 18 18 18 18 18 18 18 18 18 18 18 
18 18 18 18 18 18 18 18 18 18 18 18 18 18 18 18 27 27 18 8 8 8 8 8 8 8 8 8 8 8 8 18 27 27 27 27 27 27 27 27 27 27 27 27 27 27 8 8 8 8 8 8 8 8 8 8 27 27 27 27 27 27 18 8 8 8 8 8 8 8 8 8 8 8 8 18 27 27 27 27 27 27 27 27 18 18 18 18 18 18 18 18 18 18 18 18 18 18 18 18 
18 18 18 18 18 18 18 18 18 18 18 18 18 18 18 18 27 27 18 8 8 8 8 8 8 8 8 8 8 8 8 18 27 27 27 27 27 21 1 1 11 18 27 27 27 18 8 8 8 8 8 8 8 8 8 8 18 27 27 27 27 27 18 8 8 8 8 8 8 8 8 8 8 8 8 18 27 27 27 27 27 27 27 27 18 18 18 18 18 18 18 18 18 18 18 18 18 18 18 18 
18 18 18 18 18 18 18 18 18 18 18 18 18 18 18 18 27 27 18 8 8 8 8 8 8 8 8 8 8 8 8 18 27 27 18 21 1 23 14 14 0 1 11 27 27 6 8 8 8 8 8 8 8 8 8 8 6 27 27 27 27 27 18 8 8 8 8 8 8 8 8 8 8 8 8 18 27 27 27 27 27 27 27 27 18 18 18 18 18 18 18 18 18 18 18 18 18 18 18 18 
18 18 18 18 18 18 18 18 18 18 18 18 18 18 18 18 27 27 18 4 4 4 4 4 4 4 4 4 4 4 4 18 27 21 1 23 14 14 14 14 14 14 0 11 27 5 4 4 4 4 4 4 4 4 4 4 5 27 27 27 27 27 18 4 4 4 4 4 4 4 4 4 4 4 4 18 27 27 27 27 27 27 27 27 18 18 18 18 18 18 18 18 18 18 18 18 18 18 18 18 
18 18 18 18 18 18 18 18 18 18 18 18 18 18 18 18 27 27 18 4 4 4 4 4 4 4 4 4 4 4 4 18 27 20 22 14 14 14 14 14 14 14 12 13 27 18 4 4 4 4 4 4 4 4 4 4 18 27 27 27 27 27 18 4 4 10 4 4 4 4 4 4 10 4 4 18 27 27 27 27 27 27 27 27 18 18 18 18 18 18 18 18 18 18 18 18 18 18 18 18 
18 18 18 18 18 18 18 18 18 18 18 18 18 18 18 18 27 27 18 4 4 10 4 4 19 19 4 4 10 4 4 18 27 27 20 22 14 14 14 14 14 12 13 27 27 6 4 10 4 4 19 19 4 4 10 4 6 27 27 27 27 27 18 4 10 4 10 4 19 19 4 10 4 10 4 18 27 27 27 27 27 27 27 27 18 18 18 18 18 18 18 18 18 18 18 18 18 18 18 18 
18 18 18 18 18 18 18 18 18 18 18 18 18 18 18 18 27 27 18 2 2 2 2 2 19 19 2 2 2 2 2 18 27 27 27 20 17 17 17 17 17 13 18 27 27 5 2 2 2 2 19 19 2 2 2 2 5 27 27 27 27 27 18 2 2 2 2 2 19 19 2 2 2 2 2 18 27 27 27 27 27 27 27 27 18 18 18 18 18 18 18 18 18 18 18 18 18 18 18 18 
18 18 18 18 18 18 18 18 18 18 18 18 18 18 18 18 27 27 18 18 18 18 18 18 9 9 18 18 18 18 18 18 27 27 27 27 27 27 27 27 27 27 27 27 27 27 18 18 18 18 9 9 18 18 18 18 27 27 27 27 27 27 18 18 18 18 18 18 9 9 18 18 18 18 18 18 27 27 27 27 27 27 27 27 18 18 18 18 18 18 18 18 18 18 18 18 18 18 18 18 
18 18 18 18 18 18 18 18 18 18 18 18 18 18 18 18 27 27 27 27 27 27 27 18 9 9 18 27 27 27 27 27 27 27 27 27 27 27 27 27 27 27 27 27 27 27 27 27 27 18 9 9 18 27 27 27 27 27 27 27 27 27 27 27 27 27 27 18 9 9 18 27 27 27 27 27 27 27 27 27 27 27 27 27 18 18 18 18 18 18 18 18 18 18 18 18 18 18 18 18 
18 18 18 18 18 18 18 18 18 18 18 18 18 18 18 18 27 27 27 27 27 27 27 18 9 9 18 27 27 27 27 27 27 27 27 27 27 27 27 27 27 27 27 27 27 27 27 27 27 18 9 9 18 27 27 27 27 27 27 27 27 27 27 27 27 27 27 18 9 9 18 27 27 27 27 27 27 27 27 27 27 27 27 27 18 18 18 18 18 18 18 18 18 18 18 18 18 18 18 18 
18 18 18 18 18 18 18 18 18 18 18 18 18 18 18 18 27 27 27 27 27 27 27 18 9 9 18 27 27 27 27 27 27 27 27 27 27 27 27 27 27 27 27 27 27 27 27 27 27 18 9 9 18 27 27 27 27 27 27 27 27 27 27 27 27 27 27 18 9 9 18 27 27 27 27 27 27 27 27 27 27 27 27 27 18 18 18 18 18 18 18 18 18 18 18 18 18 18 18 18 
18 18 18 18 18 18 18 18 18 18 18 18 18 18 18 18 9 9 7 7 7 7 7 7 16 16 7 7 7 7 7 7 7 7 7 7 7 7 7 7 7 7 7 7 7 7 7 7 7 7 16 16 7 7 7 7 7 7 7 7 7 7 7 7 7 7 7 7 16 16 7 7 7 7 7 7 7 7 7 7 7 7 7 9 9 18 18 18 18 18 18 18 18 18 18 18 18 18 18 18 
18 18 18 18 18 18 18 18 18 18 18 18 18 18 18 18 9 9 25 25 25 25 25 25 25 25 25 25 25 25 25 25 25 25 25 24 24 25 25 25 25 25 25 25 25 25 25 25 25 25 25 25 25 25 25 25 25 25 25 25 25 25 25 25 25 25 25 25 25 25 25 24 24 25 25 25 25 25 25 25 25 25 25 9 9 18 18 18 18 18 18 18 18 18 18 18 18 18 18 18 
18 18 18 18 18 18 18 18 18 18 18 18 18 18 18 18 9 9 27 27 27 27 27 27 27 27 27 27 27 27 27 27 27 27 18 9 9 18 27 27 27 27 27 27 27 27 27 27 27 27 27 27 27 27 27 27 27 27 27 27 27 27 27 27 27 27 27 27 27 27 18 9 9 18 27 27 27 27 27 27 27 27 27 9 9 18 18 18 18 18 18 18 18 18 18 18 18 18 18 18 
18 18 18 18 18 18 18 18 18 18 18 18 18 18 18 18 9 9 27 27 27 27 27 27 27 27 27 27 27 27 27 27 27 27 18 9 9 18 27 27 27 27 27 27 27 27 27 27 27 27 27 27 27 27 27 27 27 27 27 27 27 27 27 27 27 27 27 27 27 27 18 9 9 18 27 27 27 27 27 27 27 27 27 9 9 18 18 18 18 18 18 18 18 18 18 18 18 18 18 18 
18 18 18 18 18 18 18 18 18 18 18 18 18 18 18 18 9 9 27 27 27 27 27 27 27 27 27 27 27 27 27 27 27 27 18 9 9 18 27 27 27 27 27 27 27 27 27 27 27 6 6 6 6 6 6 6 6 6 6 6 6 27 27 27 27 27 27 27 27 27 18 9 9 18 27 27 27 27 27 27 27 27 27 9 9 18 18 18 18 18 18 18 18 18 18 18 18 18 18 18 
18 18 18 18 18 18 18 18 18 18 18 18 18 18 18 18 9 9 27 27 27 27 27 27 27 27 27 27 27 27 27 27 27 27 18 9 9 18 27 27 27 27 27 27 27 27 27 27 18 8 8 8 8 8 8 8 8 8 8 8 8 18 27 27 27 27 27 18 18 18 18 9 9 18 18 18 18 27 27 27 27 27 27 9 9 18 18 18 18 18 18 18 18 18 18 18 18 18 18 18 
18 18 18 18 18 18 18 18 18 18 18 18 18 18 18 18 9 9 27 27 27 27 27 27 27 27 27 27 27 27 18 8 8 8 8 8 8 8 8 8 8 18 27 27 27 27 27 27 27 8 8 8 8 8 8 8 8 8 8 8 8 27 27 27 27 27 27 18 8 8 8 8 8 8 8 8 18 27 27 27 27 27 27 9 9 18 18 18 18 18 18 18 18 18 18 18 18 18 18 18 
18 18 18 18 18 18 18 18 18 18 18 18 18 18 18 18 9 9 27 27 27 27 27 27 27 27 27 27 27 27 18 8 8 8 8 8 8 8 8 8 8 18 27 27 27 27 27 27 18 8 8 8 8 8 8 8 8 8 8 8 8 18 27 27 27 27 27 18 8 8 8 8 8 8 8 8 18 27 27 27 27 27 27 9 9 18 18 18 18 18 18 18 18 18 18 18 18 18 18 18 
18 18 18 18 18 18 18 18 18 18 18 18 18 18 18 18 9 9 27 27 27 27 27 27 27 27 27 27 27 27 18 8 8 8 8 8 8 8 8 8 8 18 27 27 27 27 27 27 27 4 4 4 4 4 4 4 4 4 4 4 4 27 27 27 27 27 27 18 8 8 8 8 8 8 8 8 18 27 27 27 27 27 27 9 9 18 18 18 18 18 18 18 18 18 18 18 18 18 18 18 
18 18 18 18 18 18 18 18 18 18 18 18 18 18 18 18 9 9 27 27 27 27 27 27 27 27 27 27 27 27 18 8 8 8 8 8 8 8 8 8 8 18 27 27 27 27 27 27 18 4 4 10 4 4 4 4 4 4 10 4 4 18 27 27 27 27 27 18 8 8 8 8 8 8 8 8 18 27 27 27 27 27 27 9 9 18 18 18 18 18 18 18 18 18 18 18 18 18 18 18 
18 18 18 18 18 18 18 18 18 18 18 18 18 18 18 18 9 9 27 27 27 27 27 27 27 27 27 27 27 27 18 4 4 4 4 4 4 4 4 4 4 18 27 27 27 27 27 27 27 4 10 4 10 4 19 19 4 10 4 10 4 27 27 27 27 27 27 18 4 10 4 4 4 4 4 4 18 27 27 27 27 27 27 9 9 18 18 18 18 18 18 18 18 18 18 18 18 18 18 18 
18 18 18 18 18 18 18 18 18 18 18 18 18 18 18 18 9 9 27 27 27 27 27 27 27 27 27 27 27 27 18 4 4 10 4 4 4 4 10 4 4 18 27 27 27 27 27 27 18 2 2 2 2 2 19 19 2 2 2 2 2 18 27 27 27 27 27 18 4 4 4 4 4 4 10 4 18 27 27 27 27 27 27 9 9 18 18 18 18 18 18 18 18 18 18 18 18 18 18 18 
18 18 18 18 18 18 18 18 18 18 18 18 18 18 18 18 9 9 27 27 27 27 27 27 27 27 27 27 27 27 18 2 2 2 2 2 2 2 2 2 2 18 27 27 27 27 27 27 27 18 27 18 27 18 9 9 18 27 18 27 18 27 27 27 27 27 27 18 2 2 2 2 2 2 2 2 18 27 27 27 27 27 27 9 9 18 18 18 18 18 18 18 18 18 18 18 18 18 18 18 
18 18 18 18 18 18 18 18 18 18 18 18 18 18 18 18 9 9 27 27 27 27 27 27 27 27 27 27 27 27 18 18 18 18 18 18 18 18 18 18 18 18 27 27 27 27 27 27 27 27 27 27 27 27 9 9 27 27 27 27 27 27 27 27 27 27 27 18 18 18 18 18 18 18 18 18 18 27 27 27 27 27 27 9 9 18 18 18 18 18 18 18 18 18 18 18 18 18 18 18 
18 18 18 18 18 18 18 18 18 18 18 18 18 18 18 18 9 9 27 27 27 27 27 27 27 27 27 27 27 27 27 27 27 27 27 27 27 27 27 27 27 27 27 27 27 27 27 27 27 27 27 27 27 18 9 9 18 27 27 27 27 27 27 27 27 27 27 27 27 27 27 27 27 27 27 27 27 27 27 27 27 27 27 9 9 18 18 18 18 18 18 18 18 18 18 18 18 18 18 18 
18 18 18 18 18 18 18 18 18 18 18 18 18 18 18 18 9 9 7 7 7 7 7 7 7 7 7 7 7 7 7 7 7 7 7 7 7 7 7 7 7 7 7 7 7 7 7 7 7 7 7 7 7 7 16 16 7 7 7 7 7 7 7 7 7 7 7 7 7 7 7 7 7 7 7 7 7 7 7 7 7 7 7 9 9 18 18 18 18 18 18 18 18 18 18 18 18 18 18 18 
18 18 18 18 18 18 18 18 18 18 18 18 18 18 18 18 9 9 25 25 25 25 25 25 25 25 25 24 24 25 25 25 25 25 25 25 25 25 25 25 25 25 25 25 25 25 25 24 24 25 25 25 25 25 25 25 25 25 25 25 25 25 25 25 25 25 25 25 25 25 24 24 25 25 25 25 25 25 25 25 25 25 25 9 9 18 18 18 18 18 18 18 18 18 18 18 18 18 18 18 
18 18 18 18 18 18 18 18 18 18 18 18 18 18 18 18 9 9 27 27 27 27 27 27 27 27 18 9 9 18 27 27 27 27 27 27 27 27 27 27 27 27 27 27 27 27 27 9 9 27 27 27 27 27 27 27 27 27 27 27 27 27 27 27 27 27 27 27 27 27 9 9 27 27 27 27 27 27 27 27 27 27 27 9 9 18 18 18 18 18 18 18 18 18 18 18 18 18 18 18 
18 18 18 18 18 18 18 18 18 18 18 18 18 18 18 18 9 9 27 27 27 27 27 27 27 27 18 9 9 18 27 27 27 27 27 27 27 27 27 27 27 27 27 27 27 27 27 9 9 27 27 27 27 27 27 27 27 27 27 27 27 27 27 27 27 27 27 27 27 27 9 27 27 27 27 27 27 27 27 27 27 27 27 9 9 18 18 18 18 18 18 18 18 18 18 18 18 18 18 18 
18 18 18 18 18 18 18 18 18 18 18 18 18 18 18 18 9 9 27 27 27 27 27 27 27 27 18 9 9 18 27 27 27 27 27 27 27 27 27 27 27 27 27 6 6 6 6 9 9 6 6 6 6 27 27 27 27 27 27 27 27 27 27 27 27 27 27 27 27 27 27 27 27 27 18 18 18 27 27 27 27 27 27 9 9 18 18 18 18 18 18 18 18 18 18 18 18 18 18 18 
18 18 18 18 18 18 18 18 18 18 18 18 18 18 18 18 9 9 27 27 27 27 27 8 8 8 8 8 8 8 8 8 8 27 27 27 27 27 27 27 27 27 6 8 8 8 8 8 8 8 8 8 8 6 27 27 27 27 27 27 27 18 18 18 18 18 18 27 27 27 27 9 27 18 18 18 18 18 18 18 27 27 27 9 9 18 18 18 18 18 18 18 18 18 18 18 18 18 18 18 
18 18 18 18 18 18 18 18 18 18 18 18 18 18 18 18 9 9 27 27 27 27 27 8 8 8 8 8 8 8 8 8 8 27 27 27 27 27 27 27 27 27 5 8 8 8 8 8 8 8 8 8 8 5 27 27 27 27 27 18 18 18 18 18 18 18 18 18 18 18 9 27 18 18 6 18 18 18 18 18 18 27 27 9 9 18 18 18 18 18 18 18 18 18 18 18 18 18 18 18 
18 18 18 18 18 18 18 18 18 18 18 18 18 18 18 18 9 9 27 27 27 27 27 8 8 8 8 8 8 8 8 8 8 27 27 27 27 27 27 27 27 27 18 8 8 8 8 8 8 8 8 8 8 18 27 27 27 27 18 18 18 18 27 27 27 18 18 6 18 18 18 9 18 18 5 27 27 27 27 18 6 18 27 9 9 18 18 18 18 18 18 18 18 18 18 18 18 18 18 18 
18 18 18 18 18 18 18 18 18 18 18 18 18 18 18 18 9 9 27 27 27 27 27 8 8 8 8 8 8 8 8 8 8 27 27 27 27 27 27 27 27 27 6 8 8 8 8 8 8 8 8 8 8 6 27 27 27 18 18 18 18 18 27 27 18 18 18 5 18 18 18 27 18 18 18 27 27 27 27 27 5 18 27 9 9 18 18 18 18 18 18 18 18 18 18 18 18 18 18 18 
18 18 18 18 18 18 18 18 18 18 18 18 18 18 18 18 9 9 27 27 27 27 27 4 4 4 4 4 4 4 4 4 4 27 27 27 27 27 27 27 27 27 5 4 4 4 4 4 4 4 4 4 4 5 27 27 27 18 18 6 18 18 18 27 27 27 27 27 27 27 27 27 27 27 27 27 27 27 27 27 27 18 18 9 9 18 18 18 18 18 18 18 18 18 18 18 18 18 18 18 
18 18 18 18 18 18 18 18 18 18 18 18 18 18 18 18 9 9 27 27 27 27 27 4 10 4 4 4 4 4 4 10 4 27 27 27 27 27 27 27 27 27 18 4 4 10 4 4 4 4 10 4 4 18 27 27 27 18 18 5 18 18 18 18 18 18 27 18 18 18 18 27 18 18 18 27 27 27 27 27 27 18 18 9 9 18 18 18 18 18 18 18 18 18 18 18 18 18 18 18 
18 18 18 18 18 18 18 18 18 18 18 18 18 18 18 18 9 9 27 27 27 27 27 2 2 2 2 2 2 2 2 2 2 27 27 27 27 27 27 27 27 27 6 2 2 2 2 2 2 2 2 2 2 6 27 27 27 27 18 18 18 18 18 18 18 18 27 18 18 18 18 27 18 6 18 27 27 27 27 18 18 18 18 9 9 18 18 18 18 18 18 18 18 18 18 18 18 18 18 18 
18 18 18 18 18 18 18 18 18 18 18 18 18 18 18 18 9 9 27 27 27 27 27 27 27 27 27 27 27 27 27 27 27 27 27 27 27 27 27 27 27 27 5 18 18 18 18 18 18 18 18 18 18 5 27 27 27 27 27 18 18 18 27 27 27 27 27 18 6 18 18 27 18 5 18 18 18 18 18 18 18 18 18 9 9 18 18 18 18 18 18 18 18 18 18 18 18 18 18 18 
18 18 18 18 18 18 18 18 18 18 18 18 18 18 18 18 9 9 27 27 27 27 27 27 27 27 27 27 27 27 27 27 27 27 27 27 27 27 27 27 27 27 27 27 27 27 27 27 27 27 27 27 27 27 27 27 27 27 27 18 18 18 27 18 18 18 18 18 5 18 18 27 18 18 5 18 18 18 18 18 18 18 18 9 9 18 18 18 18 18 18 18 18 18 18 18 18 18 18 18 
18 18 18 18 18 18 18 18 18 18 18 18 18 18 18 18 9 9 27 27 27 27 27 27 27 27 27 27 27 27 27 27 27 27 27 27 27 27 27 27 27 27 27 27 27 27 27 27 27 27 27 27 27 27 27 27 27 27 27 27 18 18 18 18 18 18 18 18 18 18 18 27 18 18 18 18 18 18 18 18 18 27 27 9 9 18 18 18 18 18 18 18 18 18 18 18 18 18 18 18 
18 18 18 18 18 18 18 18 18 18 18 18 18 18 18 18 9 9 7 7 7 7 7 7 7 7 7 7 7 7 7 7 7 7 7 7 7 7 7 7 7 7 7 7 7 7 7 7 7 7 7 7 7 7 7 7 7 7 7 7 7 7 7 7 7 7 7 7 7 7 7 7 7 7 7 7 7 7 7 7 7 7 7 9 9 18 18 18 18 18 18 18 18 18 18 18 18 18 18 18 
18 18 18 18 18 18 18 18 18 18 18 18 18 18 18 18 9 9 25 25 25 25 25 25 25 25 25 25 24 24 25 25 25 25 25 25 25 25 25 25 25 25 25 25 25 25 25 25 25 25 25 25 25 25 25 25 25 25 25 25 25 25 25 25 25 25 25 25 25 25 25 25 25 25 25 25 25 25 25 25 25 25 25 9 9 18 18 18 18 18 18 18 18 18 18 18 18 18 18 18 
18 18 18 18 18 18 18 18 18 18 18 18 18 18 18 18 18 27 27 27 27 27 27 27 27 27 27 18 9 9 18 27 27 27 27 27 27 27 27 27 27 27 27 27 27 27 27 27 27 27 27 27 27 27 27 27 27 27 27 27 27 27 18 18 18 18 18 18 18 18 18 18 18 18 18 18 18 18 27 18 18 18 18 18 18 18 18 18 18 18 18 18 18 18 18 18 18 18 18 18 
18 18 18 18 18 18 18 18 18 18 18 18 18 18 18 18 18 18 27 27 27 27 27 27 27 27 27 18 9 9 18 27 27 27 27 27 27 27 27 27 27 27 27 27 27 27 27 27 27 27 27 27 27 27 27 27 27 27 27 27 27 18 18 18 18 18 18 18 18 18 18 18 18 18 18 18 18 18 27 18 18 18 18 18 18 18 18 18 18 18 18 18 18 18 18 18 18 18 18 18 
18 18 18 18 18 18 18 18 18 18 18 18 18 18 18 18 18 18 18 27 27 27 18 18 18 18 18 18 9 9 18 18 18 18 18 18 18 27 27 27 27 27 27 27 27 27 27 27 27 27 27 27 27 27 27 27 27 27 27 27 18 18 18 18 18 18 18 18 18 18 18 18 18 18 18 18 18 27 27 18 18 18 18 18 18 18 18 18 18 18 18 18 18 18 18 18 18 18 18 18 
18 18 18 18 18 18 18 18 18 18 18 18 18 18 18 18 18 18 18 18 18 18 18 18 18 18 18 18 9 9 18 18 18 18 18 18 18 18 18 18 18 27 27 27 27 27 27 27 27 27 27 27 27 27 27 27 27 27 27 18 18 18 18 18 18 18 18 18 18 18 18 18 18 18 18 18 18 27 18 18 18 18 18 18 18 18 18 18 18 18 18 18 18 18 18 18 18 18 18 18 
18 18 18 18 18 18 18 18 18 18 18 18 18 18 18 18 18 18 18 8 8 8 8 8 8 8 8 8 8 8 8 8 8 8 8 8 8 8 8 8 18 18 18 18 18 18 18 18 18 18 18 18 18 18 18 18 18 18 18 18 18 18 18 18 18 18 18 18 18 18 18 18 18 18 18 18 18 27 18 18 18 18 18 18 18 18 18 18 18 18 18 18 18 18 18 18 18 18 18 18 
18 18 18 18 18 18 18 18 18 18 18 18 18 18 18 18 27 27 18 8 8 8 8 8 8 8 8 8 8 8 8 8 8 8 8 8 8 8 8 8 18 27 27 27 27 27 27 27 27 27 27 27 27 27 27 27 27 27 18 18 18 18 18 18 18 18 18 18 18 18 18 18 18 18 18 18 18 27 18 18 18 18 18 18 18 18 18 18 18 18 18 18 18 18 18 18 18 18 18 18 
18 18 18 18 18 18 18 18 18 18 18 18 18 18 27 27 27 27 18 8 8 8 8 8 8 8 8 8 8 8 8 8 8 8 8 8 8 8 8 8 18 27 27 27 27 27 27 21 1 1 11 27 27 27 27 27 27 18 18 18 18 18 18 18 18 18 18 18 18 18 18 18 18 18 18 18 18 27 18 18 18 18 18 18 18 18 18 18 18 18 18 18 18 18 18 18 18 18 18 18 
18 18 18 18 18 18 18 18 18 18 18 18 27 27 27 27 27 27 18 8 8 8 8 8 8 8 8 8 8 8 8 8 8 8 8 8 8 8 8 8 18 27 27 27 27 27 21 23 14 14 0 1 1 11 27 27 27 18 18 18 18 18 18 18 18 18 18 27 18 18 18 18 18 18 18 18 18 27 18 18 18 18 18 18 18 18 18 18 18 18 18 18 18 18 18 18 18 18 18 18 
18 18 18 18 18 18 18 18 18 18 18 27 27 27 27 27 27 27 18 4 4 4 4 4 4 4 4 4 4 4 4 4 4 4 4 4 4 4 4 4 18 27 27 27 27 21 23 14 14 14 14 14 14 0 11 27 27 18 18 18 18 18 18 18 18 18 18 27 18 18 18 18 18 18 18 18 18 27 18 18 18 18 18 18 18 18 18 18 18 18 18 18 18 18 18 18 18 18 18 18 
18 18 18 18 18 18 18 18 18 18 18 27 27 27 27 27 27 27 18 4 4 10 4 4 10 4 4 4 4 4 4 4 4 4 10 4 4 10 4 4 18 27 27 21 1 23 14 14 14 14 14 14 14 12 13 27 18 18 18 18 18 18 18 18 18 18 18 27 18 18 18 18 18 18 18 18 18 27 18 18 18 18 18 18 18 18 18 18 18 18 18 18 18 18 18 18 18 18 18 18 
18 18 18 18 18 18 18 18 18 18 18 27 27 27 27 27 27 27 18 2 2 2 2 2 2 2 2 2 2 2 2 2 2 2 2 2 2 2 2 2 18 27 27 20 22 14 14 14 14 14 14 14 12 13 27 18 18 18 18 18 18 18 18 18 18 18 18 27 27 27 27 27 27 27 27 27 27 27 27 27 18 18 18 18 18 18 18 18 18 18 18 18 18 18 18 18 18 18 18 18 
18 18 18 18 18 18 18 18 18 18 18 27 27 27 27 27 27 27 18 18 18 18 18 18 18 18 18 18 18 18 18 18 18 18 18 18 18 18 18 18 18 27 27 27 20 22 14 14 14 12 17 17 13 27 18 18 18 18 18 18 18 18 18 18 18 18 18 18 18 18 18 18 18 18 18 18 18 27 18 18 18 18 18 18 18 18 18 18 18 18 18 18 18 18 18 18 18 18 18 18 
18 18 18 18 18 18 18 18 18 18 18 18 27 27 27 27 27 27 27 27 27 27 27 27 27 27 27 27 27 27 27 27 27 27 27 27 27 27 27 27 27 27 27 27 27 20 17 17 17 13 27 27 27 18 18 18 18 18 18 18 18 18 18 27 27 18 18 18 18 18 18 18 18 18 18 18 18 27 18 18 18 18 18 18 18 18 18 18 18 18 18 18 18 18 18 18 18 18 18 18 
18 18 18 18 18 18 18 18 18 18 18 18 27 27 27 27 27 27 27 27 27 27 27 27 27 27 27 27 27 27 27 27 27 27 27 27 27 27 27 27 27 27 27 27 27 27 27 27 27 27 27 18 18 18 18 18 18 18 18 18 18 18 27 27 27 27 27 18 18 18 18 18 18 18 18 18 18 27 18 18 18 18 18 18 18 18 18 18 18 18 18 18 18 18 18 18 18 18 18 18 
18 18 18 18 18 18 18 18 18 18 18 18 18 27 27 27 27 27 27 27 27 27 27 27 27 27 27 27 27 27 27 27 27 27 27 27 27 27 27 27 27 27 27 27 27 27 27 27 27 27 18 18 18 18 18 18 18 18 18 18 27 27 27 27 27 27 27 27 27 27 27 27 27 27 27 27 27 27 18 18 18 18 18 18 18 18 18 18 18 18 18 18 18 18 18 18 18 18 18 18 
18 18 18 18 18 18 18 18 18 18 18 18 18 18 18 18 18 18 27 27 27 27 27 27 27 18 18 27 27 27 18 27 18 18 18 18 18 18 18 18 18 18 18 18 18 18 18 18 18 18 18 18 18 18 18 18 18 18 18 18 18 27 27 27 27 27 27 18 18 18 18 18 18 18 18 18 18 18 18 18 18 18 18 18 18 18 18 18 18 18 18 18 18 18 18 18 18 18 18 18 
18 18 18 18 18 18 18 18 18 18 18 18 18 18 18 18 18 18 18 18 18 27 27 18 18 18 18 18 18 18 18 18 18 18 18 18 18 18 18 18 18 18 18 18 18 18 18 18 18 18 18 18 18 18 18 18 18 18 18 18 18 18 27 27 27 27 27 18 18 18 18 18 18 18 18 18 18 18 18 18 18 18 18 18 18 18 18 18 18 18 18 18 18 18 18 18 18 18 18 18 
18 18 18 18 18 18 18 18 18 18 18 18 18 18 18 18 18 18 18 18 18 18 18 18 18 18 18 18 18 18 18 18 18 18 18 18 18 18 18 18 18 18 18 18 18 18 18 18 18 18 18 18 18 18 18 18 18 18 18 18 18 18 18 18 18 18 18 18 18 18 18 18 18 18 18 18 18 18 18 18 18 18 18 18 18 18 18 18 18 18 18 18 18 18 18 18 18 18 18 18 
18 18 18 18 18 18 18 18 18 18 18 18 18 18 18 18 18 18 18 18 18 18 18 18 18 18 18 18 18 18 18 18 18 18 18 18 18 18 18 18 18 18 18 18 18 18 18 18 18 18 18 18 18 18 18 18 18 18 18 18 18 18 18 18 18 18 18 18 18 18 18 18 18 18 18 18 18 18 18 18 18 18 18 18 18 18 18 18 18 18 18 18 18 18 18 18 18 18 18 18 
18 18 18 18 18 18 18 18 18 18 18 18 18 18 18 18 18 18 18 18 18 18 18 18 18 18 18 18 18 18 18 18 18 18 18 18 18 18 18 18 18 18 18 18 18 18 18 18 18 18 18 18 18 18 18 18 18 18 18 18 18 18 18 18 18 18 18 18 18 18 18 18 18 18 18 18 18 18 18 18 18 18 18 18 18 18 18 18 18 18 18 18 18 18 18 18 18 18 18 18 
18 18 18 18 18 18 18 18 18 18 18 18 18 18 18 18 18 18 18 18 18 18 18 18 18 18 18 18 18 18 18 18 18 18 18 18 18 18 18 18 18 18 18 18 18 18 18 18 18 18 18 18 18 18 18 18 18 18 18 18 18 18 18 18 18 18 18 18 18 18 18 18 18 18 18 18 18 18 18 18 18 18 18 18 18 18 18 18 18 18 18 18 18 18 18 18 18 18 18 18 
18 18 18 18 18 18 18 18 18 18 18 18 18 18 18 18 18 18 18 18 18 18 18 18 18 18 18 18 18 18 18 18 18 18 18 18 18 18 18 18 18 18 18 18 18 18 18 18 18 18 18 18 18 18 18 18 18 18 18 18 18 18 18 18 18 18 18 18 18 18 18 18 18 18 18 18 18 18 18 18 18 18 18 18 18 18 18 18 18 18 18 18 18 18 18 18 18 18 18 18 
18 18 18 18 18 18 18 18 18 18 18 18 18 18 18 18 18 18 18 18 18 18 18 18 18 18 18 18 18 18 18 18 18 18 18 18 18 18 18 18 18 18 18 18 18 18 18 18 18 18 18 18 18 18 18 18 18 18 18 18 18 18 18 18 18 18 18 18 18 18 18 18 18 18 18 18 18 18 18 18 18 18 18 18 18 18 18 18 18 18 18 18 18 18 18 18 18 18 18 18 
18 18 18 18 18 18 18 18 18 18 18 18 18 18 18 18 18 18 18 18 18 18 18 18 18 18 18 18 18 18 18 18 18 18 18 18 18 18 18 18 18 18 18 18 18 18 18 18 18 18 18 18 18 18 18 18 18 18 18 18 18 18 18 18 18 18 18 18 18 18 18 18 18 18 18 18 18 18 18 18 18 18 18 18 18 18 18 18 18 18 18 18 18 18 18 18 18 18 18 18 
18 18 18 18 18 18 18 18 18 18 18 18 18 18 18 18 18 18 18 18 18 18 18 18 18 18 18 18 18 18 18 18 18 18 18 18 18 18 18 18 18 18 18 18 18 18 18 18 18 18 18 18 18 18 18 18 18 18 18 18 18 18 18 18 18 18 18 18 18 18 18 18 18 18 18 18 18 18 18 18 18 18 18 18 18 18 18 18 18 18 18 18 18 18 18 18 18 18 18 18 
18 18 18 18 18 18 18 18 18 18 18 18 18 18 18 18 18 18 18 18 18 18 18 18 18 18 18 18 18 18 18 18 18 18 18 18 18 18 18 18 18 18 18 18 18 18 18 18 18 18 18 18 18 18 18 18 18 18 18 18 18 18 18 18 18 18 18 18 18 18 18 18 18 18 18 18 18 18 18 18 18 18 18 18 18 18 18 18 18 18 18 18 18 18 18 18 18 18 18 18 
18 18 18 18 18 18 18 18 18 18 18 18 18 18 18 18 18 18 18 18 18 18 18 18 18 18 18 18 18 18 18 18 18 18 18 18 18 18 18 18 18 18 18 18 18 18 18 18 18 18 18 18 18 18 18 18 18 18 18 18 18 18 18 18 18 18 18 18 18 18 18 18 18 18 18 18 18 18 18 18 18 18 18 18 18 18 18 18 18 18 18 18 18 18 18 18 18 18 18 18 
18 18 18 18 18 18 18 18 18 18 18 18 18 18 18 18 18 18 18 18 18 18 18 18 18 18 18 18 18 18 18 18 18 18 18 18 18 18 18 18 18 18 18 18 18 18 18 18 18 18 18 18 18 18 18 18 18 18 18 18 18 18 18 18 18 18 18 18 18 18 18 18 18 18 18 18 18 18 18 18 18 18 18 18 18 18 18 18 18 18 18 18 18 18 18 18 18 18 18 18 
18 18 18 18 18 18 18 18 18 18 18 18 18 18 18 18 18 18 18 18 18 18 18 18 18 18 18 18 18 18 18 18 18 18 18 18 18 18 18 18 18 18 18 18 18 18 18 18 18 18 18 18 18 18 18 18 18 18 18 18 18 18 18 18 18 18 18 18 18 18 18 18 18 18 18 18 18 18 18 18 18 18 18 18 18 18 18 18 18 18 18 18 18 18 18 18 18 18 18 18 
18 18 18 18 18 18 18 18 18 18 18 18 18 18 18 18 18 18 18 18 18 18 18 18 18 18 18 18 18 18 18 18 18 18 18 18 18 18 18 18 18 18 18 18 18 18 18 18 18 18 18 18 18 18 18 18 18 18 18 18 18 18 18 18 18 18 18 18 18 18 18 18 18 18 18 18 18 18 18 18 18 18 18 18 18 18 18 18 18 18 18 18 18 18 18 18 18 18 18 18 
18 18 18 18 18 18 18 18 18 18 18 18 18 18 18 18 18 18 18 18 18 18 18 18 18 18 18 18 18 18 18 18 18 18 18 18 18 18 18 18 18 18 18 18 18 18 18 18 18 18 18 18 18 18 18 18 18 18 18 18 18 18 18 18 18 18 18 18 18 18 18 18 18 18 18 18 18 18 18 18 18 18 18 18 18 18 18 18 18 18 18 18 18 18 18 18 18 18 18 18 
