16 16 16 16 16 16 16 16 16 16 16 16 16 16 16 16 16 16 16 16 16 16 16 16 16 16 5 16 16 23 23 13 13 13 16 16 16 16 16 16 16 16 16 16 16 16 16 16 16 16 
16 16 16 16 16 16 16 16 16 16 23 23 23 23 23 23 23 23 16 16 16 23 23 16 16 16 4 16 16 23 16 16 16 16 16 16 16 16 16 16 16 16 16 16 16 16 16 16 5 16 
16 16 16 16 16 16 16 16 16 16 23 16 16 16 16 16 16 23 16 16 16 16 23 16 16 16 16 16 16 23 16 16 16 16 16 16 16 16 23 16 16 16 16 5 16 16 16 16 4 16 
16 16 16 16 16 16 16 16 16 16 23 16 16 16 16 16 16 23 23 23 23 23 23 23 23 23 23 23 23 23 16 16 16 16 16 16 16 16 23 16 16 16 16 4 16 16 16 16 16 16 
16 16 16 16 23 23 23 23 23 23 23 16 16 16 16 16 16 23 16 16 16 16 23 16 16 16 16 16 16 23 23 23 23 23 23 23 23 23 23 23 23 23 16 16 16 23 16 16 16 16 
16 16 16 16 23 16 16 16 16 16 23 16 16 16 16 16 16 23 16 16 16 16 23 16 16 16 16 16 16 23 16 16 16 16 16 16 16 16 23 16 16 16 16 16 16 23 16 16 16 16 
16 16 16 16 23 16 16 16 16 16 23 16 16 16 16 16 16 23 16 16 16 23 23 16 16 5 16 16 16 23 16 16 16 16 16 16 16 16 16 16 16 16 16 16 16 23 16 16 16 16 
16 16 16 16 23 16 16 16 23 23 23 16 16 16 16 23 23 23 16 16 23 23 16 16 16 4 16 16 16 23 23 23 23 23 23 23 23 23 23 23 23 23 23 23 23 23 16 16 16 16 
16 16 16 16 23 16 16 16 16 16 16 16 16 16 16 16 16 16 16 16 16 16 16 16 16 16 16 16 16 16 16 16 16 16 16 16 16 16 16 16 16 16 16 16 16 16 16 16 16 16 
23 23 23 23 23 23 23 23 16 16 16 23 23 23 23 23 23 23 23 23 23 23 23 23 23 23 23 23 23 23 23 23 23 23 23 23 23 23 23 23 23 23 23 23 23 23 23 23 23 23 
23 23 23 23 23 23 23 23 23 23 23 23 23 23 23 23 23 23 23 23 23 23 23 23 23 23 23 23 23 23 23 23 23 23 23 23 23 23 23 23 23 23 23 23 23 23 23 23 23 23 
23 23 23 23 23 23 23 23 23 23 23 23 23 23 23 23 23 23 23 23 23 23 23 23 23 23 23 23 23 23 23 23 23 23 23 23 23 23 23 23 23 23 23 23 23 23 23 23 23 23 
23 23 23 23 23 23 23 23 23 23 23 23 23 23 23 23 23 23 23 23 23 23 23 23 23 23 23 23 23 23 23 23 23 23 23 23 23 23 23 23 23 23 23 23 23 23 23 23 23 23 
23 7 7 7 7 7 7 7 7 7 7 7 7 23 23 23 23 23 23 23 23 23 23 23 23 23 23 23 7 7 7 7 7 7 7 7 7 7 23 23 23 23 23 23 23 23 23 23 23 23 
23 7 7 7 7 7 7 7 7 7 7 7 7 23 23 23 23 23 23 23 23 23 23 23 23 23 23 16 7 7 7 7 7 7 7 7 7 7 16 23 23 23 23 23 16 23 23 23 23 23 
23 7 7 7 7 7 7 7 7 7 7 7 7 23 23 23 23 23 23 23 23 23 23 23 23 23 23 16 7 7 7 7 7 7 7 7 7 7 16 23 23 23 23 23 16 16 16 23 23 23 
23 3 3 3 3 3 3 3 3 3 3 3 3 23 23 23 23 23 23 23 23 23 23 23 23 23 23 16 3 3 3 3 3 3 3 3 3 3 16 23 23 23 23 23 23 23 16 16 16 23 
23 3 3 3 3 3 3 3 3 3 3 3 3 23 23 23 23 23 23 23 23 16 23 23 23 23 16 16 3 3 3 3 3 3 3 3 3 3 16 23 16 23 23 23 23 23 23 23 23 23 
23 3 3 9 3 3 17 17 3 3 9 3 3 23 23 23 23 23 23 23 23 23 23 23 23 16 16 16 3 9 3 3 17 17 3 3 9 3 16 23 23 23 23 23 23 23 23 23 23 23 
23 1 1 1 1 1 17 17 1 1 1 1 1 23 23 23 23 23 23 23 23 23 23 23 16 16 23 16 1 1 1 1 17 17 1 1 1 1 16 23 23 23 23 23 16 23 23 23 23 23 
23 16 23 16 23 16 8 8 16 23 16 23 16 23 23 23 23 23 23 23 23 23 23 23 23 23 23 16 16 16 16 16 8 8 16 16 16 16 16 23 23 23 23 23 23 23 23 23 23 23 
23 23 23 23 23 23 8 8 23 23 23 23 23 23 16 23 23 23 23 23 23 23 23 23 23 23 23 23 23 23 23 23 8 8 23 23 23 23 23 23 23 23 23 23 23 23 23 23 23 23 
23 16 23 23 23 23 8 8 23 23 23 23 23 23 23 23 23 23 23 23 23 23 23 23 23 23 23 23 23 23 23 23 8 8 23 23 23 23 23 23 23 23 23 23 23 23 23 23 23 23 
23 23 23 23 23 23 8 8 23 23 23 23 23 23 23 23 16 23 23 23 23 23 23 23 23 23 23 23 23 23 23 23 8 8 23 23 23 23 23 23 23 23 23 23 23 23 23 23 23 23 
6 6 6 6 6 6 14 14 6 6 6 6 6 6 6 6 6 6 6 6 6 6 6 6 6 6 6 6 6 6 6 6 14 14 6 6 6 6 6 6 6 6 6 6 6 6 6 6 6 6 
21 21 21 21 21 21 21 21 21 21 21 21 21 21 21 21 21 21 21 21 21 20 20 21 21 21 21 21 21 21 21 21 21 21 21 21 21 21 21 21 20 20 21 21 21 21 21 21 21 21 
23 23 23 23 23 23 23 23 23 23 23 23 23 23 23 23 23 23 23 23 16 8 8 16 23 23 23 23 23 23 23 23 23 23 23 23 23 23 23 23 8 8 23 23 23 23 23 23 23 23 
23 23 23 23 23 23 23 23 23 23 23 23 23 23 23 23 23 23 23 23 16 8 8 16 23 23 23 23 23 23 23 23 23 23 23 23 23 23 23 16 8 8 16 23 23 23 23 16 16 16 
23 23 23 23 4 23 23 23 23 23 23 23 23 23 23 23 23 23 23 23 16 8 8 16 23 23 23 23 23 23 23 23 23 23 23 23 23 23 23 16 8 8 16 23 23 23 23 16 16 16 
23 23 23 23 19 0 0 0 10 4 23 23 23 23 23 23 16 16 16 16 16 8 8 16 16 16 16 16 23 23 23 23 23 23 23 16 16 16 16 16 8 8 16 16 16 16 16 16 16 16 
23 23 4 19 12 12 12 12 12 10 23 23 23 23 17 23 16 7 7 7 7 7 7 7 7 7 7 16 23 23 23 23 23 23 23 16 7 7 7 7 7 7 7 7 7 7 16 16 16 16 
23 23 23 18 12 12 12 12 12 11 23 23 23 23 23 23 16 7 7 7 7 7 7 7 7 7 7 16 23 23 23 23 23 23 23 16 7 7 7 7 7 7 7 7 7 7 16 16 16 16 
23 23 23 4 18 15 15 15 11 4 23 23 23 23 23 23 16 7 7 7 7 7 7 7 7 7 7 16 23 23 23 23 23 23 23 16 7 7 7 7 7 7 7 7 7 7 16 16 16 16 
23 23 23 23 23 23 23 4 23 23 23 23 23 23 23 23 16 7 7 7 7 7 7 7 7 7 7 16 23 23 23 23 23 23 23 16 7 7 7 7 7 7 7 7 7 7 16 16 16 16 
23 23 23 23 23 23 23 23 23 23 23 23 23 23 23 23 16 3 9 3 3 3 3 3 3 9 3 16 23 23 23 23 23 23 23 16 3 9 3 3 3 3 3 3 9 3 16 16 16 16 
23 23 23 23 23 23 23 23 23 23 23 23 23 23 23 23 16 1 1 1 1 1 1 1 1 1 1 16 23 23 23 23 23 23 23 16 1 1 1 1 1 1 1 1 1 1 16 16 16 16 
23 23 23 23 23 23 23 23 23 23 23 23 23 23 23 23 16 16 16 16 16 16 16 16 16 16 16 16 23 23 23 23 23 23 23 16 16 16 16 16 16 16 16 16 16 16 16 16 16 16 
23 23 23 23 23 23 23 23 23 23 23 23 23 23 23 23 23 23 23 23 23 23 23 23 23 23 23 23 23 23 23 23 23 23 23 23 23 23 23 23 23 23 23 23 16 16 16 16 16 16 
23 23 23 23 23 23 23 23 23 23 23 23 23 23 23 23 23 23 23 23 16 23 19 0 0 10 23 23 16 23 23 23 23 23 23 23 23 23 23 23 23 23 23 16 16 16 16 16 16 16 
23 23 23 23 23 23 23 23 23 23 23 23 23 23 23 23 23 16 19 0 0 0 12 12 12 12 0 0 10 16 23 23 23 23 23 23 23 23 23 23 23 23 16 16 16 16 16 16 16 16 
23 23 23 23 23 23 23 23 23 23 23 23 23 23 23 23 16 19 12 12 12 12 12 12 12 12 12 12 12 10 23 16 23 23 23 23 23 23 23 23 23 16 16 16 16 16 16 16 16 16 
4 4 23 23 23 23 23 23 23 23 23 23 23 23 23 23 23 18 15 15 12 12 12 12 12 12 12 12 12 12 10 23 23 23 23 23 23 23 23 23 16 16 16 16 16 16 5 16 16 16 
16 16 16 16 16 16 16 16 16 16 23 23 23 23 23 23 23 23 16 23 18 15 12 12 12 12 12 12 12 12 11 23 23 23 23 23 23 23 16 16 16 16 16 16 16 16 4 16 16 16 
16 16 16 16 16 16 16 16 16 16 16 16 16 16 23 23 23 23 23 23 23 23 18 15 12 12 12 12 12 11 16 23 23 16 16 16 16 16 16 16 16 5 16 16 16 16 16 16 16 16 
16 16 16 16 16 16 16 16 16 5 16 16 16 16 16 16 16 16 16 23 23 23 23 16 18 15 15 15 11 23 23 16 16 16 16 16 16 16 16 16 16 4 16 16 16 16 16 16 16 16 
16 16 16 16 16 16 16 16 16 4 16 16 16 16 16 16 16 16 16 16 16 16 16 16 16 23 23 16 16 16 16 16 16 16 16 16 16 16 16 16 16 16 16 16 16 16 16 16 16 16 
16 5 16 16 16 5 16 16 16 16 16 16 16 16 16 16 16 16 16 16 16 16 16 16 16 16 16 16 16 16 16 16 16 16 16 5 16 16 16 16 16 16 16 16 5 16 16 16 16 16 
16 4 16 16 16 4 16 16 16 16 16 16 16 16 5 16 16 16 16 16 16 16 16 16 16 16 16 16 5 16 16 16 16 16 16 4 16 16 16 16 16 16 16 16 4 16 16 16 16 16 
16 16 16 16 16 16 16 16 16 16 16 16 16 16 4 16 16 16 16 16 16 16 16 16 16 16 16 16 4 16 16 16 16 16 16 16 16 16 16 16 16 16 16 16 16 16 16 16 16 16 
16 16 16 16 16 16 16 16 16 16 16 16 16 16 16 16 16 16 16 16 16 16 16 16 16 16 16 16 16 16 16 16 16 16 16 16 16 16 16 16 16 16 16 16 16 16 16 16 16 16 
