0 4 1 1 1 1 1 1 1 4 4 4 4 1 1 1 1 1 1 4 4 1 1 1 1 1 1 1 4 4 4 4 1 1 1 1 1 1 4 0
0 0 1 1 1 1 1 1 1 0 0 0 0 1 1 1 1 1 1 0 0 1 1 1 1 1 1 1 0 0 0 0 1 1 1 1 1 1 0 0
0 0 2 2 2 2 2 2 2 0 0 0 0 2 2 2 2 2 2 0 0 2 2 2 2 2 2 2 0 0 0 0 2 2 2 2 2 2 0 0
0 0 2 2 3 3 2 14 2 0 0 0 0 2 2 3 3 14 2 0 0 2 2 3 3 2 14 2 0 0 0 0 2 14 3 3 2 2 0 0
0 0 15 15 3 3 15 15 15 0 0 0 0 15 15 3 3 15 15 0 0 15 15 3 3 15 15 15 0 0 0 0 15 15 3 3 15 15 0 0
0 0 0 0 6 6 0 0 0 0 4 0 4 0 0 6 6 0 0 0 0 0 0 6 6 0 0 0 0 4 0 4 0 0 6 6 0 0 0 0
0 0 0 0 6 6 0 0 3 0 0 0 0 0 0 6 6 0 0 0 0 0 0 6 6 0 0 3 0 0 0 0 0 0 6 6 0 0 0 0
0 0 0 0 6 6 0 0 3 0 0 0 0 0 0 6 6 0 0 0 0 0 0 6 6 0 0 3 0 0 0 0 0 0 6 6 0 0 0 0
11 11 11 11 12 12 11 11 11 11 11 11 11 11 11 12 12 11 11 11 11 11 11 12 12 11 11 11 11 11 11 11 11 11 12 12 11 11 11 11
10 10 10 10 13 13 10 10 10 10 10 10 10 10 10 13 13 10 10 10 10 10 10 13 13 10 10 10 10 10 10 10 10 10 13 13 10 10 10 10
0 0 4 0 6 6 0 0 0 0 0 0 0 0 0 6 6 0 0 0 0 4 0 6 6 0 0 0 0 0 0 0 0 0 6 6 0 0 0 0
0 0 0 0 6 6 0 0 4 0 0 0 0 0 0 6 6 0 4 0 0 0 0 6 6 0 0 4 0 0 0 0 0 0 6 6 0 4 0 0
0 0 0 0 6 6 0 0 0 0 0 0 3 0 0 6 6 0 0 0 0 0 0 6 6 0 0 0 0 0 0 3 0 0 6 6 0 0 0 0
0 0 1 1 1 1 1 1 1 3 0 0 0 1 1 1 1 1 1 0 0 1 1 1 1 1 1 1 3 0 0 0 1 1 1 1 1 1 0 0
0 0 1 1 1 1 1 1 1 0 0 0 0 1 1 1 1 1 1 0 0 1 1 1 1 1 1 1 0 0 0 0 1 1 1 1 1 1 0 0
0 0 1 1 1 1 1 1 1 0 0 0 0 1 1 1 1 1 1 0 0 1 1 1 1 1 1 1 0 0 0 0 1 1 1 1 1 1 0 0
0 0 2 2 2 2 2 2 2 0 0 0 0 2 2 2 2 2 2 0 0 2 2 2 2 2 2 2 0 0 0 0 2 2 2 2 2 2 0 0
0 4 2 2 2 2 2 2 2 4 4 4 4 2 2 2 2 2 2 4 4 2 2 2 2 2 2 2 4 4 4 4 2 2 2 2 2 2 4 0