13 13 13 13 13 13 13 13 13 13 13 13 13 13 13 13 13 13 6 6 6 6 6 6 6 6 1 6 6 13 13 13 13 13 6 6 6 6 6 6 6 6 6 6 6 6 6 6 6 6 
13 6 6 6 6 6 6 6 6 6 13 6 6 6 6 6 6 13 6 6 6 13 13 6 6 6 3 6 6 13 6 6 6 6 6 6 6 6 6 6 6 6 6 6 6 6 6 6 1 6 
13 6 6 6 6 6 6 6 6 6 13 6 6 6 6 6 6 13 6 6 6 6 13 6 6 6 6 6 6 13 6 6 6 6 6 6 6 6 13 6 6 6 6 1 6 6 6 6 3 6 
13 6 6 6 6 6 6 6 6 6 13 6 6 6 6 6 6 13 13 13 13 13 13 13 13 13 13 13 13 13 6 6 6 6 6 6 6 6 13 6 6 6 6 3 6 6 6 6 6 6 
6 6 6 6 13 13 13 13 13 13 13 6 6 6 6 6 6 13 6 6 6 6 13 6 6 6 6 6 6 13 13 13 13 13 13 13 13 13 13 13 13 13 6 6 6 13 6 6 6 6 
6 6 6 6 13 6 6 6 6 6 13 6 6 6 6 6 6 13 6 6 6 6 13 6 6 6 6 6 6 13 6 6 6 6 6 6 6 6 13 6 6 6 6 6 6 13 6 6 6 6 
6 6 6 6 13 6 6 6 6 6 13 6 6 6 6 6 6 13 6 6 6 13 13 6 6 1 6 6 6 13 6 6 6 6 6 6 6 6 6 6 6 6 6 6 6 13 6 6 6 6 
6 6 6 6 13 6 6 6 13 13 13 6 6 6 6 13 13 13 6 6 13 13 6 6 6 3 6 6 6 13 13 13 13 13 13 13 13 13 13 13 13 13 13 13 13 13 6 6 6 6 
6 6 6 6 13 6 6 6 6 6 6 6 6 6 6 6 6 6 6 6 6 6 6 6 6 6 6 6 6 6 6 6 6 6 6 6 6 6 6 6 6 6 6 6 6 6 6 6 6 6 
13 13 13 13 13 13 13 13 6 6 6 13 13 13 13 13 13 13 13 13 13 13 13 13 13 13 13 13 13 13 13 13 13 13 13 13 13 13 13 13 13 13 13 13 13 13 13 13 13 13 
13 13 13 13 13 13 13 13 13 13 13 13 13 13 13 13 13 13 13 13 13 13 13 13 13 13 13 13 13 13 13 13 13 13 13 13 13 13 13 13 13 13 13 13 13 13 13 13 13 13 
13 13 13 13 13 13 13 13 13 13 13 13 13 13 13 13 13 13 13 13 13 13 13 13 13 13 13 13 13 13 13 13 13 13 13 13 13 13 13 13 13 13 13 13 13 13 13 13 13 13 
13 13 13 13 13 13 13 13 13 13 13 13 13 13 13 13 13 13 13 13 13 13 13 13 13 13 13 13 13 13 13 13 13 13 13 13 13 13 13 13 13 13 13 13 13 13 13 13 13 13 
13 0 0 0 0 0 0 0 0 0 0 0 0 13 13 13 13 13 13 13 13 13 13 13 13 13 13 13 0 0 0 0 0 0 0 0 0 0 13 13 13 13 13 13 13 13 13 13 13 13 
13 0 0 0 0 0 0 0 0 0 0 0 0 13 13 13 13 13 13 13 13 13 13 13 13 13 13 6 0 0 0 0 0 0 0 0 0 0 6 13 13 13 13 13 6 13 13 13 13 13 
13 0 0 0 0 0 0 0 0 0 0 0 0 13 13 13 13 13 13 13 13 13 13 13 13 13 13 6 0 0 0 0 0 0 0 0 0 0 6 13 13 13 13 13 6 6 6 13 13 13 
13 4 4 4 4 4 4 4 4 4 4 4 4 13 13 13 13 13 13 13 13 13 13 13 13 13 13 6 12 12 12 12 12 12 12 12 12 12 6 13 13 13 13 13 13 13 6 6 6 13 
13 4 4 4 4 4 4 4 4 4 4 4 4 13 13 13 13 13 13 13 13 6 13 13 13 13 6 6 12 12 12 12 12 12 12 12 12 12 6 13 6 13 13 13 13 13 13 13 13 13 
13 4 4 8 4 4 7 7 4 4 8 4 4 13 13 13 13 13 13 13 13 13 13 13 13 6 6 6 12 8 4 12 7 7 12 12 8 12 6 13 13 13 13 13 13 13 13 13 13 13 
13 12 12 12 12 12 7 7 12 12 12 12 12 13 13 13 13 13 13 13 13 13 13 13 6 6 13 6 12 12 12 12 7 7 12 12 12 12 6 13 13 13 13 13 6 13 13 13 13 13 
13 6 13 6 13 6 5 5 6 13 6 13 6 13 13 13 13 13 13 13 13 13 13 13 13 13 13 6 6 6 6 6 5 5 6 6 6 6 6 13 13 13 13 13 13 13 13 13 13 13 
13 13 13 13 13 13 5 5 13 13 13 13 13 13 6 13 13 13 13 13 13 13 13 13 13 13 13 13 13 13 13 13 5 5 13 13 13 13 13 13 13 13 13 13 13 13 13 13 13 13 
13 6 13 13 13 13 5 5 13 13 13 13 13 13 13 13 13 13 13 13 13 13 13 13 13 13 13 13 13 13 13 13 5 5 13 13 13 13 13 13 13 13 13 13 13 13 13 13 13 13 
13 13 13 13 13 13 5 5 13 13 13 13 13 13 13 13 6 13 13 13 13 13 13 13 13 13 13 13 13 13 13 13 5 5 13 13 13 13 13 13 13 13 13 13 13 13 13 13 13 13 
11 11 11 11 11 11 16 16 11 11 11 11 11 11 11 11 11 11 11 11 11 11 11 11 11 11 11 11 11 11 11 11 16 16 11 11 11 11 11 11 11 11 11 11 11 11 11 11 11 11 
10 10 10 10 10 10 10 10 10 10 10 10 10 10 10 10 10 10 10 10 10 14 14 10 10 10 10 10 10 10 10 10 10 10 10 10 10 10 10 10 14 14 10 10 10 10 10 10 10 10 
13 13 13 13 13 13 13 13 13 13 13 13 13 13 13 13 13 13 13 13 6 5 5 6 13 13 13 13 13 13 13 13 13 13 13 13 13 13 13 6 5 5 6 13 13 13 13 6 6 6 
13 13 13 13 13 13 13 13 13 13 13 13 13 13 13 13 13 13 13 13 6 5 5 6 13 13 13 13 13 13 13 13 13 13 13 13 13 13 13 6 5 5 6 13 13 13 13 6 6 6 
13 13 13 13 6 13 13 13 13 13 13 13 13 13 13 13 13 13 13 13 6 5 5 6 13 13 13 13 13 13 13 13 13 13 13 13 13 13 13 6 5 5 6 13 13 13 13 6 6 6 
13 13 13 13 9 9 9 9 9 6 13 13 13 13 13 13 6 6 6 6 6 5 5 6 6 6 6 6 13 13 13 13 13 13 13 6 6 6 6 6 5 5 6 6 6 6 6 6 6 6 
13 13 6 9 9 9 9 9 9 9 13 13 13 13 6 13 6 0 0 0 0 0 0 0 0 0 0 6 13 13 13 13 13 13 13 6 0 0 0 0 0 0 0 0 0 0 6 6 6 6 
13 13 13 9 9 9 9 9 9 9 13 13 13 13 13 13 6 0 0 0 0 0 0 0 0 0 0 6 13 13 13 13 13 13 13 6 0 0 0 0 0 0 0 0 0 0 6 6 6 6 
13 13 13 6 9 9 9 9 9 6 13 13 13 13 13 13 6 0 0 0 0 0 0 0 0 0 0 6 13 13 13 13 13 13 13 6 0 0 0 0 0 0 0 0 0 0 6 6 6 6 
13 13 13 13 13 13 6 13 13 13 13 13 13 13 13 13 6 0 0 0 0 0 0 0 0 0 0 6 13 13 13 13 13 13 13 6 0 0 0 0 0 0 0 0 0 0 6 6 6 6 
13 13 13 13 13 13 13 13 13 13 13 13 13 13 13 13 6 4 8 4 4 4 4 4 4 8 4 6 13 13 13 13 13 13 13 6 4 8 4 4 4 4 4 4 8 4 6 6 6 6 
13 13 13 13 13 13 13 13 13 13 13 13 13 13 13 13 6 12 12 12 12 12 12 12 12 12 12 6 13 13 13 13 13 13 13 6 12 12 12 12 12 12 12 12 12 12 6 6 6 6 
13 13 13 13 13 13 13 13 13 13 13 13 13 13 13 13 6 6 6 6 6 6 6 6 6 6 6 6 13 13 13 13 13 13 13 6 6 6 6 6 6 6 6 6 6 6 6 6 6 6 
13 13 13 13 13 13 13 13 13 13 13 13 13 13 13 13 13 13 13 13 13 13 13 13 13 13 13 13 13 13 13 13 13 13 13 13 13 13 13 13 13 13 13 13 6 6 6 6 6 6 
13 13 13 13 13 13 13 13 13 13 13 13 13 13 13 13 13 13 13 13 6 13 9 9 9 9 13 13 6 13 13 13 13 13 13 13 13 13 13 13 13 13 13 6 6 6 6 6 6 6 
13 13 13 13 13 13 13 13 13 13 13 13 13 13 13 13 13 6 9 9 9 9 9 9 9 9 9 9 9 6 13 13 13 13 13 13 13 13 13 13 13 13 6 6 6 6 6 6 6 6 
13 13 13 13 13 13 13 13 13 13 13 13 13 13 13 13 6 9 9 9 9 9 9 9 9 9 9 9 9 9 13 6 13 13 13 13 13 13 13 13 13 6 6 6 6 6 6 6 6 6 
6 6 13 13 13 13 13 13 13 13 13 13 13 13 13 13 13 9 9 9 9 9 9 9 9 9 9 9 9 9 9 13 13 13 13 13 13 13 13 13 6 6 6 6 6 6 1 6 6 6 
6 6 6 6 6 6 6 6 6 6 13 13 13 13 13 13 13 13 6 13 9 9 9 9 9 9 9 9 9 9 9 13 13 13 13 13 13 13 6 6 6 6 6 6 6 6 3 6 6 6 
6 6 6 6 6 6 6 6 6 6 6 6 6 6 13 13 13 13 13 13 13 13 9 9 9 9 9 9 9 9 6 13 13 6 6 6 6 6 6 6 6 1 6 6 6 6 6 6 6 6 
6 6 6 6 6 6 6 6 6 1 6 6 6 6 6 6 6 6 6 13 13 13 13 6 9 9 9 9 9 13 13 6 6 6 6 6 6 6 6 6 6 3 6 6 6 6 6 6 6 6 
6 6 6 6 6 6 6 6 6 3 6 6 6 6 6 6 6 6 6 6 6 6 6 6 6 13 13 6 6 6 6 6 6 6 6 6 6 6 6 6 6 6 6 6 6 6 6 6 6 6 
6 1 6 6 6 1 6 6 6 6 6 6 6 6 6 6 6 6 6 6 6 6 6 6 6 6 6 6 6 6 6 6 6 6 6 1 6 6 6 6 6 6 6 6 1 6 6 6 6 6 
6 3 6 6 6 3 6 6 6 6 6 6 6 6 1 6 6 6 6 6 6 6 6 6 6 6 6 6 1 6 6 6 6 6 6 3 6 6 6 6 6 6 6 6 3 6 6 6 6 6 
6 6 6 6 6 6 6 6 6 6 6 6 6 6 3 6 6 6 6 6 6 6 6 6 6 6 6 6 3 6 6 6 6 6 6 6 6 6 6 6 6 6 6 6 6 6 6 6 6 6 
6 6 6 6 6 6 6 6 6 6 6 6 6 6 6 6 6 6 6 6 6 6 6 6 6 6 6 6 6 6 6 6 6 6 6 6 6 6 6 6 6 6 6 6 6 6 6 6 6 6 
